écus	écu
abacuses	abacus
abas	aba
abbés	abbé
abbesses	abbess
abdullas	abdulla
abilities	ability
abnormalities	abnormality
abos	abo
abscesses	abscess
abscissae	abscissa
absences	absence
absorbances	absorbance
absurdities	absurdity
abundances	abundance
abuses	abuse
abysses	abyss
acacias	acacia
academies	academy
acceptances	acceptance
accesses	access
accessories	accessory
accuracies	accuracy
accused	accused
acetabula	acetabulum
acetyltransferases	acetyltransferase
aches	ache
acidaemias	acidaemia
acini	acinus
acmes	acme
acolytes	acolyte
acquaintances	acquaintance
acquiescences	acquiescence
acres	acre
actas	acta
activities	activity
actresses	actress
actuaries	actuary
actuses	actus
addenda	addendum
additivities	additivity
addresses	address
adelphis	adelphi
adenocarcinomata	adenocarcinoma
adenomata	adenoma
adenopathies	adenopathy
adenoviruses	adenovirus
adequacies	adequacy
adherences	adherence
adipocytes	adipocyte
adjacencies	adjacency
admirables	admirable
adrenalectomies	adrenalectomy
adulteries	adultery
advances	advance
adversaries	adversary
adverses	adverse
adversities	adversity
advisories	advisory
adzes	adze
aegises	aegis
aetiologies	aetiology
affinities	affinity
aficionados	aficionado
afros	afro
afterdischarges	afterdischarge
agas	aga
agencies	agency
agendas	agenda
agenesises	agenesis
agonies	agony
agorot	agora
agrs	agr
agues	ague
aids	aid
ailettes	ailette
airbases	airbase
aircraft	aircraft
airmen	airman
aisles	aisle
akalis	akali
albatrosses	albatross
albedos	albedo
albinos	albino
alcaldes	alcalde
aldehydes	aldehyde
aldermen	alderman
alexandras	alexandra
algae	alga
algebras	algebra
alhajis	alhaji
aliases	alias
alibis	alibi
alkalinities	alkalinity
alkalis	alkali
allegiances	allegiance
allegories	allegory
allergies	allergy
alliances	alliance
allies	ally
allowables	allowable
allowances	allowance
alloys	alloy
almas	alma
aloes	aloe
alphas	alpha
alsos	also
alternativas	alternativa
alumnae	alumna
alumni	alumnus
alveoli	alveolus
ambassies	ambassy
ambiences	ambience
ambiguities	ambiguity
ambivalences	ambivalence
ambulances	ambulance
ambushes	ambush
amebae	ameba
amebas	ameba
amenities	amenity
amerikas	amerika
amici	amicus
amigos	amigo
amities	amity
amnesties	amnesty
amnia	amnion
amniocenteses	amniocentesis
amoebae	amoeba
amoebas	amoeba
amoebiases	amoebiasis
amphitheatres	amphitheatre
amphorae	amphora
ampullae	ampulla
amygdalae	amygdala
analogies	analogy
analogues	analogue
analyses	analyse
analyses	analysis
analytes	analyte
anancies	anancy
anaphoras	anaphora
anastomoses	anastomosis
anathemas	anathema
anatomies	anatomy
ancestries	ancestry
anchovies	anchovy
anchyloses	anchylosis
ancillaries	ancillary
angiomata	angioma
angioplasties	angioplasty
angles	angle
anglos	anglo
anguishes	anguish
animas	anima
animosities	animosity
anis	ani
ankles	ankle
annas	anna
annexes	annex
anniversaries	anniversary
annoyances	annoyance
annuities	annuity
annuli	annulus
anomalies	anomaly
ansayris	ansayri
antennae	antenna
anthologies	anthology
anthonies	anthony
antibodies	antibody
antigenicities	antigenicity
antinomies	antinomy
antipathies	antipathy
antiquaries	antiquary
antiquities	antiquity
antis	anti
antitheses	antithesis
antra	antrum
anuses	anus
anxieties	anxiety
anybodies	anybody
aortas	aorta
apaches	apache
apexes	apex
apocalypses	apocalypse
apologias	apologia
apologies	apology
aponeuroses	aponeurosis
apoplexies	apoplexy
aporias	aporia
apostasies	apostasy
apostles	apostle
apostrophes	apostrophe
apothecaries	apothecary
apotheoses	apotheosis
apparatuses	apparatus
appearances	appearance
applauses	applause
apples	apple
appliances	appliance
applies	apply
approaches	approach
apras	apra
apses	apse
aquaria	aquarium
arbitraries	arbitrary
archdioceses	archdiocese
arches	arch
archetypes	archetype
archies	archie
archipelagoes	archipelago
areas	area
arenas	arena
areolae	areola
arguses	argus
arias	aria
aris	ari
aristocracies	aristocracy
armadas	armada
armadillos	armadillo
armies	army
armouries	armoury
aromas	aroma
arroyos	arroyo
arses	arse
arteries	artery
arthropathies	arthropathy
arthroplasties	arthroplasty
articles	article
artificialities	artificiality
artilleries	artillery
artillerymen	artilleryman
artistes	artiste
ashes	ash
ashkenazis	ashkenazi
asparaguses	asparagus
aspergilluses	aspergillus
aspirin	aspirin
asps	asp
assemblies	assembly
assemblymen	assemblyman
asses	ass
assurances	assurance
astrocytes	astrocyte
astrocytomas	astrocytoma
asymmetries	asymmetry
atms	atm
atpases	atpase
atria	atrium
atrocities	atrocity
attachés	attaché
attendances	attendance
attorneys-general	attorney-general
audiences	audience
auditoria	auditorium
auditories	auditory
auguries	augury
augustes	auguste
aunties	auntie
aurae	aura
aurei	aureus
auricles	auricle
aurorae	aurora
austerities	austerity
autarkies	autarky
authorities	authority
autoantibodies	autoantibody
autobiographies	autobiography
automata	automaton
autonomies	autonomy
autopsies	autopsy
autos	auto
auxiliaries	auxiliary
availabilities	availability
avalanches	avalanche
avenues	avenue
avocados	avocado
avoidances	avoidance
axes	axe
axillae	axilla
ayres	ayre
azaleas	azalea
azotaemias	azotaemia
babies	baby
bacchuses	bacchus
bacilli	bacillus
backlashes	backlash
bacteria	bacterium
badges	badge
badmen	badman
bahasas	bahasa
bakeries	bakery
balances	balance
balconies	balcony
balinese	balinese
ballerinas	ballerina
baluches	baluch
bamboos	bamboo
banalities	banality
bananas	banana
banburies	banbury
bandannas	bandanna
bangles	bangle
banjoes	banjo
banjos	banjo
bankruptcies	bankruptcy
barbaras	barbara
barbarities	barbarity
barbecues	barbecue
barbies	barbie
barges	barge
barmen	barman
baronies	barony
barres	barre
barrios	barrio
basemen	baseman
bases	base
bases	basis
basilicas	basilica
basses	bass
batavias	batavia
batches	batch
batteries	battery
battles	battle
bayous	bayou
beaches	beach
beauties	beauty
beauvaises	beauvais
beaux	beau
becauses	because
bedouin	bedouin
beeches	beech
beetles	beetle
belfries	belfry
belles	belle
bellies	belly
bellinis	bellini
benches	bench
beneficences	beneficence
beneficiaries	beneficiary
bengalis	bengali
berries	berry
berthas	bertha
betas	beta
betsies	betsy
betties	betty
bevies	bevy
biases	bias
bibles	bible
bibliographies	bibliography
bicycles	bicycle
bigotries	bigotry
biharis	bihari
bikinis	bikini
binaries	binary
binges	binge
biographies	biography
biopsies	biopsy
bios	bio
birches	birch
bitches	bitch
bivalves	bivalve
bizarres	bizarre
blackberries	blackberry
blackfoot	blackfoot
blasphemies	blasphemy
blemishes	blemish
blitzes	blitz
blockhouses	blockhouse
blondes	blonde
blotches	blotch
blouses	blouse
blueberries	blueberry
blues	blue
blushes	blush
boar	boar
boas	boa
boat	boat
boatmen	boatman
boches	boche
bodhisattvas	bodhisattva
bodies	body
bogies	bogy
boluses	bolus
bonanzas	bonanza
bondsmen	bondsman
bonies	bony
bonnes	bonne
bonuses	bonus
boobies	booby
bookcases	bookcase
bookshelves	bookshelf
boos	boo
booties	booty
boras	bora
bosses	boss
botticellis	botticelli
bottles	bottle
bounces	bounce
boundaries	boundary
bounties	bounty
bourgeois	bourgeois
bourgeoisies	bourgeoisie
bowmen	bowman
boxes	box
boys	boy
braceros	bracero
bradburies	bradbury
brahmanas	brahmana
brahmos	brahmo
brambles	bramble
branches	branch
brandies	brandy
bras	bra
brasses	brass
bravos	bravo
breaches	breach
breeches	breech
breweries	brewery
briberies	bribery
bridges	bridge
bridles	bridle
briefcases	briefcase
bristles	bristle
bronchi	bronchus
bronchoscopies	bronchoscopy
bronzes	bronze
brooches	brooch
brownies	brownie
bruises	bruise
brunettes	brunette
brushes	brush
brutalities	brutality
bubbles	bubble
buckles	buckle
buddas	budda
buffaloes	buffalo
buffalos	buffalo
buggies	buggy
bugles	bugle
bulges	bulge
bulkies	bulky
bullae	bulla
bullies	bully
bunches	bunch
bundles	bundle
bureaucracies	bureaucracy
bureaux	bureau
burgesses	burgess
burglaries	burglary
burgundies	burgundy
burros	burro
bursae	bursa
buses	bus
bushes	bush
bushmen	bushman
businessmen	businessman
businesspeople	businessperson
businesswomen	businesswoman
butcheries	butchery
butches	butch
butterflies	butterfly
buttes	butte
buttresses	buttress
buys	buy
byes	bye
bypasses	bypass
bytes	byte
cañas	caña
cabbalas	cabbala
cabildos	cabildo
cables	cable
cacaos	cacao
caches	cache
cacophonies	cacophony
cacti	cactus
cactuses	cactus
caddies	caddy
cadences	cadence
cadis	cadi
cadres	cadre
caeca	caecum
caesuras	caesura
cafés	café
cafeterias	cafeteria
calabashes	calabash
calamities	calamity
calculuses	calculus
calderas	caldera
calibres	calibre
calicoes	calico
callas	calla
calluses	callus
calories	calorie
calumnies	calumny
calves	calf
calyces	calyx
calyxes	calyx
cameos	cameo
cameramen	cameraman
cameras	camera
campesinos	campesino
campoos	campoo
campuses	campus
canaliculuses	canaliculus
canaries	canary
candelabra	candelabrum
candidacies	candidacy
candidas	candida
candies	candy
candles	candle
canneries	cannery
cannulae	cannula
canoes	canoe
canopies	canopy
cantatas	cantata
canthi	canthus
canti	cantus
canticles	canticle
cantonese	cantonese
cantos	canto
canvases	canvas
capabilities	capability
capacitances	capacitance
capacities	capacity
capillaries	capillary
captivities	captivity
carboxypeptidases	carboxypeptidase
carcasses	carcass
carcinomata	carcinoma
cardinalities	cardinality
caresses	caress
cargoes	cargo
caribou	caribou
carmen	carman
carolinas	carolina
carries	carry
cartes	carte
cartridges	cartridge
cases	case
cash	cash
casinos	casino
cassettes	cassette
cassinos	cassino
castes	caste
castles	castle
casualties	casualty
casuistries	casuistry
catalogues	catalogue
catastrophes	catastrophe
categories	category
catharses	catharsis
cattlemen	cattleman
caucuses	caucus
caudas	cauda
caudillos	caudillo
causes	cause
cauteries	cautery
cavalries	cavalry
cavas	cava
cavities	cavity
ceases	cease
celebrities	celebrity
cellae	cella
cellos	cello
cemeteries	cemetery
censuses	census
centenaries	centenary
centilitres	centilitre
centimetres	centimetre
centra	centrum
centres	centre
centuries	century
ceos	ceo
cerebella	cerebellum
cerebra	cerebrum
ceremonies	ceremony
certainties	certainty
cesses	cess
cfas	cfa
cfcs	cfc
châteaux	château
chaebol	chaebol
chaggas	chagga
chairmen	chairman
chaises	chaise
chakras	chakra
challenges	challenge
champagnes	champagne
chanceries	chancery
chances	chance
changes	change
chaoses	chaos
charges	charge
charities	charity
chases	chase
chassis	chassis
chechen	chechen
cheeses	cheese
chemistries	chemistry
cherokee	cherokee
cherries	cherry
cheyenne	cheyenne
chiasmata	chiasma
chicanas	chicana
chicanos	chicano
chickenpoxes	chickenpox
chickpeas	chickpea
children	child
chillies	chilli
chimeras	chimera
chinamen	chinaman
chinas	china
chis	chi
chivalries	chivalry
cholecystectomies	cholecystectomy
cholesteatomas	cholesteatoma
chondrocytes	chondrocyte
chondrosarcomas	chondrosarcoma
chordas	chorda
choreas	chorea
choreographies	choreography
choriocarcinomata	choriocarcinoma
choruses	chorus
choses	chose
chous	chou
christies	christie
christmases	christmas
chronicles	chronicle
chronologies	chronology
churches	church
churchmen	churchman
cicadas	cicada
cigarettes	cigarette
cilias	cilia
cinemas	cinema
circles	circle
circuitries	circuitry
circumferences	circumference
circumstances	circumstance
circuses	circus
cirri	cirrus
cisternas	cisterna
cities	city
citizenries	citizenry
citruses	citrus
clansmen	clansman
clashes	clash
classes	class
clauses	clause
clavicles	clavicle
clearances	clearance
clerestories	clerestory
clergies	clergy
clergymen	clergyman
clichés	cliché
climaxes	climax
clitorises	clitoris
clos	clo
closes	close
clues	clue
clunies	cluny
clutches	clutch
coaches	coach
coachmen	coachman
coalescences	coalescence
cobras	cobra
cocas	coca
cocci	coccus
cochleae	cochlea
cockroaches	cockroach
cocoas	cocoa
cocos	coco
codas	coda
codexes	codex
codices	codex
coelias	coelia
coexistences	coexistence
coffeehouses	coffeehouse
cogencies	cogency
coherences	coherence
coincidences	coincidence
colas	cola
colemen	coleman
colis	coli
collagenases	collagenase
collapses	collapse
colleagues	colleague
collegia	collegium
colliculi	colliculus
collieries	colliery
collinses	collins
colloquia	colloquium
colloquies	colloquy
colognes	cologne
colonies	colony
colonoscopies	colonoscopy
colossi	colossus
colostomies	colostomy
comanche	comanche
comas	coma
combos	combo
combustibles	combustible
comedies	comedy
comfortables	comfortable
comities	comity
commandos	commando
commas	comma
commentaries	commentary
commissaries	commissary
committeemen	committeeman
commodities	commodity
commonalities	commonality
communiqués	communiqué
communities	community
comorbidities	comorbidity
compadres	compadre
companies	company
compas	compa
compasses	compass
compatibles	compatible
compendia	compendium
competences	competence
complementarities	complementarity
complexes	complex
complexities	complexity
compromises	compromise
comtes	comte
comuses	comus
concavities	concavity
concerti	concerto
conches	conch
concierges	concierge
concordances	concordance
concourses	concourse
concurrences	concurrence
concurrencies	concurrency
condolences	condolence
condos	condo
conductances	conductance
conductivities	conductivity
condyles	condyle
condylomata	condyloma
confectioneries	confectionery
confederacies	confederacy
conferences	conference
confidantes	confidante
confidences	confidence
confidentialities	confidentiality
confluences	confluence
confraternities	confraternity
congolese	congolese
congresses	congress
congressmen	congressman
congruences	congruence
congruities	congruity
coni	conus
conidia	conidium
conies	cony
conjunctivae	conjunctiva
connivences	connivence
consciences	conscience
consensuses	consensus
consequences	consequence
conservatories	conservatory
conserves	conserve
considerables	considerable
consistencies	consistency
consistories	consistory
consonances	consonance
consortia	consortium
conspiracies	conspiracy
constables	constable
constituencies	constituency
consultancies	consultancy
contés	conté
contemporaries	contemporary
contes	conte
contingencies	contingency
continua	continuum
continuances	continuance
continuities	continuity
contradictories	contradictory
contraltos	contralto
contraries	contrary
contras	contra
contrivances	contrivance
controllers-general	controller-general
controversies	controversy
convalescences	convalescence
conveniences	convenience
convergences	convergence
convexes	convex
conveyances	conveyance
convoys	convoy
cookeries	cookery
cookies	cookie
coolies	coolie
copies	copy
copulas	copula
coras	cora
coriolises	coriolis
corneas	cornea
cornucopias	cornucopia
corollaries	corollary
coronae	corona
corpses	corpse
corpuscles	corpuscle
corpuses	corpus
correspondences	correspondence
corsos	corso
cortèges	cortège
cortis	corti
corvées	corvée
corvettes	corvette
corynebacteria	corynebacterium
coses	cos
cosmogonies	cosmogony
cosmologies	cosmology
cosmoses	cosmos
cosses	coss
costae	costa
coteries	coterie
cottas	cotta
couches	couch
coulées	coulée
countenances	countenance
counterbalances	counterbalance
countesses	countess
counties	county
countries	country
countrymen	countryman
coupés	coupé
couples	couple
courses	course
courtesies	courtesy
covariances	covariance
cow-peas	cow-pea
cowboys	cowboy
cowles	cowle
cowries	cowrie
coxes	cox
coynyes	coynye
cpus	cpu
crèches	crèche
crèmes	crème
crêpes	crêpe
cradles	cradle
craftsmen	craftsman
cranberries	cranberry
crania	cranium
craniotomies	craniotomy
crannies	cranny
crayfish	crayfish
creases	crease
credences	credence
credos	credo
cree	cree
creek	creek
crematoria	crematorium
crescendos	crescendo
crevasses	crevasse
crewmen	crewman
cries	cry
cripples	cripple
crises	crise
crises	crisis
cristae	crista
criteria	criterion
crocuses	crocus
cronies	crony
crosses	cross
crucibles	crucible
crucifixes	crucifix
crudities	crudity
cruelties	cruelty
cruises	cruise
crunches	crunch
crura	crus
crus	cru
crushes	crush
crusoes	crusoe
crutches	crutch
cubicles	cubicle
cuckoos	cuckoo
cuentos	cuento
cues	cue
cumuli	cumulus
cupolas	cupola
curias	curia
curios	curio
curiosities	curiosity
currencies	currency
curricula	curriculum
curses	curse
curves	curve
customaries	customary
cuticles	cuticle
cutlasses	cutlass
cuvettes	cuvette
cyanobacteria	cyanobacterium
cycles	cycle
cyclooxygenases	cyclooxygenase
cyclopses	cyclops
cynthias	cynthia
cypresses	cypress
cyses	cys
cytometries	cytometry
détentes	détente
dadas	dada
daddies	daddy
dados	dado
dahlias	dahlia
dailies	daily
dainties	dainty
dairies	dairy
daises	dais
daisies	daisy
damas	dama
dances	dance
dandies	dandy
danishes	danish
daphnias	daphnia
darbies	darby
darcies	darcy
darkies	darkie
dases	das
databases	database
dats	dat
davies	davy
davises	davis
deadmen	deadman
deas	dea
debacles	debacle
debaucheries	debauchery
debilities	debility
debyes	debye
deccas	decca
decimetres	decimetre
decos	deco
decreases	decrease
deductibles	deductible
deer	deer
defences	defence
deficiencies	deficiency
defies	defy
deformities	deformity
dehiscences	dehiscence
deities	deity
delaware	delaware
delicacies	delicacy
delinquencies	delinquency
delis	deli
deliverances	deliverance
deliveries	delivery
deltas	delta
demagogues	demagogue
demesnes	demesne
democracies	democracy
demos	demo
demos	demo
denarii	denarius
denis	deni
densities	density
dependencies	dependency
depositories	depository
depravities	depravity
deputies	deputy
derbies	derby
derechos	derecho
dermatoses	dermatosis
dervishes	dervish
desiderata	desideratum
desirables	desirable
desperadoes	desperado
destinies	destiny
deterrences	deterrence
devas	deva
diagnoses	diagnosis
dialogues	dialogue
dialyses	dialysis
dianas	diana
diapauses	diapause
diaries	diary
diarrhœas	diarrhœa
diasporas	diaspora
diatheses	diathesis
dichotomies	dichotomy
dicta	dictum
dictionaries	dictionary
dies	die
dieses	diesis
dietaries	dietary
differences	difference
differentiae	differentia
difficulties	difficulty
diffusivities	diffusivity
digbies	digby
dignitaries	dignitary
dignities	dignity
dilemmas	dilemma
dilettantes	dilettante
diligences	diligence
dimensionalities	dimensionality
dimples	dimple
dinghies	dinghy
dins	din
dioceses	diocese
diplomas	diploma
directories	directory
dirges	dirge
disabilities	disability
disappearances	disappearance
disassemblies	disassembly
discharges	discharge
disciples	disciple
discontinuances	discontinuance
discontinuities	discontinuity
discordances	discordance
discos	disco
discourses	discourse
discoveries	discovery
discrepancies	discrepancy
discuses	discus
diseases	disease
diseconomies	diseconomy
disequilibria	disequilibrium
disguises	disguise
dishes	dish
dishonesties	dishonesty
diskettes	diskette
disloyalties	disloyalty
dismutases	dismutase
disparities	disparity
dispatches	dispatch
dispensaries	dispensary
dispenses	dispense
disposes	dispose
disses	diss
dissimilarities	dissimilarity
dissonances	dissonance
distances	distance
distilleries	distillery
disturbances	disturbance
disunities	disunity
ditches	ditch
ditties	ditty
dittos	ditto
divergences	divergence
diversities	diversity
diverticula	diverticulum
divinities	divinity
divorces	divorce
doñas	doña
documentaries	documentary
does	doe
dogmas	dogma
doilies	doily
dollies	dolly
dominoes	domino
données	donnée
doorhandles	doorhandle
doormen	doorman
doras	dora
dormancies	dormancy
dormitories	dormitory
dorsa	dorsum
doses	dose
douais	douai
doubles	double
douglases	douglas
dowries	dowry
drachmae	drachma
draftsmen	draftsman
dragonflies	dragonfly
dramas	drama
drams	dram
draperies	drapery
drawbridges	drawbridge
dresses	dress
dries	dry
druses	druse
dualities	duality
duchennes	duchenne
duchesses	duchess
duchies	duchy
ducti	ductus
dues	due
duffles	duffle
dummies	dummy
duodena	duodenum
duos	duo
duplexes	duplex
duras	dura
dutchmen	dutchman
duties	duty
dvds	dvd
dyes	dye
dynamos	dynamo
dynasties	dynasty
dynes	dyne
dyscrasias	dyscrasia
dyskinesias	dyskinesia
dysrhythmias	dysrhythmia
dystrophies	dystrophy
eagles	eagle
eagres	eagre
eastmen	eastman
eaux	eau
ebonies	ebony
eccentricities	eccentricity
ecchymoses	ecchymosis
ecclesias	ecclesia
echoes	echo
eclipses	eclipse
eclogues	eclogue
ecms	ecm
economies	economy
ecstasies	ecstasy
eddies	eddy
edges	edge
edibles	edible
efficiencies	efficiency
effigies	effigy
effronteries	effrontery
egos	ego
egresses	egress
eigenvalues	eigenvalue
ejidos	ejido
elapses	elapse
electrolytes	electrolyte
electros	electro
elegances	elegance
elegies	elegy
ellipses	ellipse
elves	elf
embargoes	embargo
embassies	embassy
emboli	embolus
embroideries	embroidery
embryoes	embryo
embryos	embryo
emergencies	emergency
emigrés	emigré
eminences	eminence
emissaries	emissary
emmys	emmy
emphases	emphasis
employées	employée
employés	employé
emporia	emporium
empresses	empress
empties	empty
empyemas	empyema
emus	emu
encephalopathies	encephalopathy
encomia	encomium
encomiendas	encomienda
encumbrances	encumbrance
encyclopaedias	encyclopaedia
endarterectomies	endarterectomy
endonucleases	endonuclease
endoscopies	endoscopy
endothelia	endothelium
enemas	enema
enemata	enema
enemies	enemy
energies	energy
englishes	english
englishmen	englishman
englishwomen	englishwoman
enigmas	enigma
enmities	enmity
enormities	enormity
enos	eno
enquiries	enquiry
ensembles	ensemble
ententes	entente
enterococci	enterococcus
enteroviruses	enterovirus
enterprises	enterprise
enthalpies	enthalpy
entireties	entirety
entities	entity
entrées	entrée
entrances	entrance
entreaties	entreaty
entries	entry
entropies	entropy
envies	envy
envoys	envoy
enzymes	enzyme
eofs	eof
epicentres	epicentre
epicondyles	epicondyle
epidermises	epidermis
epiglottises	epiglottis
epilogues	epilogue
epiphanies	epiphany
epiphyses	epiphysis
episcopacies	episcopacy
epistles	epistle
epithelia	epithelium
equalities	equality
equilibria	equilibrium
equinoxes	equinox
equivalences	equivalence
equivalencies	equivalency
eras	era
erases	erase
ericas	erica
ernies	ernie
errata	erratum
erythrocytes	erythrocyte
eskimos	eskimo
espressos	espresso
essences	essence
estuaries	estuary
eternities	eternity
ethnicities	ethnicity
etiquettes	etiquette
etymologies	etymology
eucalypti	eucalyptus
eugenias	eugenia
eulogies	eulogy
euros	euro
eventualities	eventuality
evidences	evidence
evs	ev
examples	example
excellences	excellence
excellencies	excellency
excesses	excess
exchanges	exchange
excises	excise
excrescences	excrescence
excuses	excuse
exegeses	exegesis
exempla	exemplum
exercises	exercise
exes	ex
exigencies	exigency
existences	existence
expanses	expanse
expectancies	expectancy
expediencies	expediency
expenses	expense
experiences	experience
exploratories	exploratory
exposés	exposé
expos	expo
expresses	express
externalities	externality
extraordinaries	extraordinary
extras	extra
extravagances	extravagance
extravaganzas	extravaganza
extrema	extremum
extremities	extremity
exuberances	exuberance
eyeglasses	eyeglass
eyelashes	eyelash
fêtes	fête
fables	fable
facilities	facility
facta	factum
factories	factory
faculties	faculty
fairies	fairy
fallacies	fallacy
falsities	falsity
familiae	familia
familiarities	familiarity
families	family
fancies	fancy
fannies	fanny
fantasies	fantasy
farmhouses	farmhouse
fas	fa
fascias	fascia
fascicles	fascicle
fasciculi	fasciculus
fatalities	fatality
fatigues	fatigue
fatties	fatty
faunae	fauna
fdi	fdi
februaries	february
feet	foot
feinnes	feinne
felicities	felicity
fellas	fella
felonies	felony
feminas	femina
femininities	femininity
femmes	femme
fences	fence
fermis	fermi
ferocities	ferocity
fetishes	fetish
fets	fet
fetuses	fetus
feus	feu
fiancés	fiancé
fiascos	fiasco
fibres	fibre
fibromata	fibroma
fibrosarcomata	fibrosarcoma
fibulae	fibula
fiddles	fiddle
fiestas	fiesta
fifties	fifty
figaros	figaro
figurae	figura
filipinos	filipino
fimbriae	fimbria
finalities	finality
finches	finch
fineries	finery
finesses	finesse
finishes	finish
fireflies	firefly
firemen	fireman
fisheries	fishery
fishermen	fisherman
fishes	fish
fistulae	fistula
fitzes	fitz
flagella	flagellum
flamingoes	flamingo
flanges	flange
flatteries	flattery
fleas	flea
flexibles	flexible
flies	fly
flimsies	flimsy
floes	floe
floppies	floppy
florae	flora
florences	florence
flotillas	flotilla
flourishes	flourish
flues	flue
fluoroscopies	fluoroscopy
flurries	flurry
fluxes	flux
fob	fob
foci	focus
foes	foe
foetuses	foetus
foibles	foible
folia	folium
folies	folie
folios	folio
follicles	follicle
follies	folly
fontanelles	fontanelle
footmen	footman
foramina	foramen
forces	force
forecastles	forecastle
forefeet	forefoot
foremen	foreman
foretastes	foretaste
forgeries	forgery
forges	forge
formalities	formality
formes	forme
formosas	formosa
formulae	formula
formularies	formulary
formulas	formula
fortes	forte
fortescues	fortescue
forties	forty
fortresses	fortress
fossae	fossa
fosses	fosse
foveae	fovea
foxes	fox
fröhliches	fröhlich
fragrances	fragrance
frailties	frailty
franchises	franchise
fraternities	fraternity
freckles	freckle
freedmen	freedman
freelances	freelance
freemen	freeman
freewomen	freewoman
frenchmen	frenchman
frenchwomen	frenchwoman
frenzies	frenzy
frequencies	frequency
frescoes	fresco
freshmen	freshman
friendlies	friendly
fringes	fringe
fritzes	fritz
frontiermen	frontierman
fugues	fugue
fulani	fulani
fulcra	fulcrum
functionalities	functionality
functionaries	functionary
fundi	fundus
fungi	fungus
funguses	fungus
furies	fury
futurities	futurity
gênes	gêne
gabbros	gabbro
gables	gable
gadis	gadi
galactosidases	galactosidase
galas	gala
galaxies	galaxy
gallantries	gallantry
gallas	galla
gallegos	gallego
galleries	gallery
gametophytes	gametophyte
gammas	gamma
gandharvas	gandharva
ganglia	ganglion
garibaldis	garibaldi
garos	garo
gases	gas
gashes	gash
gastrectomies	gastrectomy
gastrocnemii	gastrocnemius
gastrostomies	gastrostomy
gatehouses	gatehouse
gauchos	gaucho
gaudies	gaudy
gazelle	gazelle
gazettes	gazette
gearboxes	gearbox
geese	goose
geishas	geisha
gendarmeries	gendarmery
gendarmes	gendarme
genealogies	genealogy
genera	genus
generalities	generality
generosities	generosity
generouses	generous
genesises	genesis
genies	genie
genii	genius
genoese	genoese
genotypes	genotype
genres	genre
gentes	gens
gentilities	gentility
gentlemen	gentleman
gentles	gentle
gentlewomen	gentlewoman
geographies	geography
geometries	geometry
georgianas	georgiana
geos	geo
ghazis	ghazi
ghettoes	ghetto
gifs	gif
gigabytes	gigabyte
giggles	giggle
gillies	gillie
gingivae	gingiva
gipsies	gipsy
giraffes	giraffe
girdles	girdle
glandes	glans
glasses	glass
glimpses	glimpse
glioblastomata	glioblastoma
gliomata	glioma
globuses	globus
glorias	gloria
glories	glory
glossaries	glossary
glosses	gloss
glossies	glossy
glottises	glottis
glucinas	glucina
glues	glue
glutaeuses	glutaeus
gneisses	gneiss
goddesses	goddess
goes	go
golas	gola
gondolas	gondola
gonococci	gonococcus
goodbyes	goodbye
goodies	goody
goodmen	goodman
gooseberries	gooseberry
gorges	gorge
gorillas	gorilla
gosses	goss
gourous	gourou
governors-general	governor-general
gpas	gpa
graben	graben
gracilises	gracilis
graffiti	graffito
granaries	granary
grandchildren	grandchild
grandmas	grandma
granite	granita
grannies	granny
granulocytes	granulocyte
granulomata	granuloma
granulomatoses	granulomatosis
grapefruit	grapefruit
grapples	grapple
grasses	grass
gratuities	gratuity
gravies	gravy
greenhouses	greenhouse
gregories	gregory
grievances	grievance
grilles	grille
grimaldis	grimaldi
gringos	gringo
groceries	grocery
grottoes	grotto
grouse	grouse
grudges	grudge
grundies	grundy
guanos	guano
guarani	guarani
guaranties	guaranty
guardsmen	guardsman
guerrillas	guerrilla
guesses	guess
guilder	guilder
guineas	guinea
guis	gui
guises	guise
gujaratis	gujarati
gullies	gully
gunas	guna
gunmen	gunman
gurkhas	gurkha
gurus	guru
guys	guy
gymnasia	gymnasium
gyri	gyrus
gyros	gyro
h's	h
habeases	habeas
hacendados	hacendado
haciendas	hacienda
hadith	hadith
haemangiomata	haemangioma
haematomata	haematoma
hagiographies	hagiography
haida	haida
haikus	haiku
hair-dos	hair-do
hakkas	hakka
halfas	halfa
halfpennies	halfpenny
halibut	halibut
haloes	halo
halves	half
hamartomas	hamartoma
hamen	haman
handles	handle
hangmen	hangman
haplotypes	haplotype
harmonicas	harmonica
harmonies	harmony
harpies	harpy
harries	harry
hashimotos	hashimoto
hassles	hassle
hatcheries	hatchery
hatches	hatch
haunches	haunch
haus	hau
hausa	hausa
havanas	havana
headaches	headache
headmen	headman
hearses	hearse
heartaches	heartache
heavies	heavy
hedges	hedge
hegemonies	hegemony
heinies	heinie
heiresses	heiress
helas	hela
hellos	hello
helmholtzes	helmholtz
helmsmen	helmsman
henries	henry
henries	henry
henriettas	henrietta
hepatocytes	hepatocyte
hepatomata	hepatoma
hepatosplenomegalies	hepatosplenomegaly
herdsmen	herdsman
herero	herero
heresies	heresy
herniae	hernia
heroes	hero
herren	herr
hertzes	hertz
hesitancies	hesitancy
hexes	hex
hexoses	hexose
hiatuses	hiatus
hickories	hickory
hierarchies	hierarchy
highwaymen	highwayman
hila	hilum
hilaries	hilary
hillbillies	hillbilly
hindrances	hindrance
hindus	hindu
hinges	hinge
hippies	hippie
hippocampi	hippocampus
hippopotami	hippopotamus
histiocytes	histiocyte
histiocytoses	histiocytosis
histories	history
hitches	hitch
hmong	hmong
hmos	hmo
hoaxes	hoax
hobbies	hobby
hoboes	hobo
holies	holy
hollies	holly
hombres	hombre
homelesses	homeless
homeostases	homeostasis
homilies	homily
hommes	homme
homologies	homology
homologues	homologue
homos	homo
honeysuckles	honeysuckle
horas	hora
hordes	horde
hornblendes	hornblende
horribles	horrible
horsemen	horseman
horseradishes	horseradish
horses	horse
horseshoes	horseshoe
hos	ho
hoses	hose
hostesses	hostess
hotchkisses	hotchkiss
hothouses	hothouse
hourglasses	hourglass
houses	house
hues	hue
huis	hui
humas	huma
humeri	humerus
humidities	humidity
hunches	hunch
huntsmen	huntsman
hurdles	hurdle
husbandmen	husbandman
hydes	hyde
hydrangeas	hydrangea
hydras	hydra
hydronephroses	hydronephrosis
hydroxylases	hydroxylase
hyenas	hyena
hyperbolae	hyperbola
hypercapnias	hypercapnia
hyperplasias	hyperplasia
hyphae	hypha
hypocrisies	hypocrisy
hypophysectomies	hypophysectomy
hypoplasias	hypoplasia
hypothalami	hypothalamus
hypotheses	hypothesis
hysterectomies	hysterectomy
hysterias	hysteria
ibos	ibo
icicles	icicle
iconographies	iconography
icus	icu
idealities	ideality
ideas	idea
identities	identity
ideologies	ideology
ideologues	ideologue
idiocies	idiocy
idiosyncrasies	idiosyncrasy
idiotypes	idiotype
idles	idle
idolatries	idolatry
ignominies	ignominy
iguanas	iguana
ilea	ileum
ileostomies	ileostomy
ilia	ilium
illegalities	illegality
illegitimacies	illegitimacy
illinoises	illinois
illiteracies	illiteracy
illuminances	illuminance
imaginaries	imaginary
imagos	imago
imbalances	imbalance
imbecilities	imbecility
immanences	immanence
immediacies	immediacy
immenses	immense
immensities	immensity
imminences	imminence
immoralities	immorality
immunities	immunity
immunodeficiencies	immunodeficiency
immunohistochemistries	immunohistochemistry
immunoreactivities	immunoreactivity
immutabilities	immutability
impasses	impasse
impedances	impedance
impertinences	impertinence
impetuses	impetus
impieties	impiety
importances	importance
importunities	importunity
impossibilities	impossibility
impossibles	impossible
impotences	impotence
impresarios	impresario
improprieties	impropriety
imprudences	imprudence
impudences	impudence
impulses	impulse
impurities	impurity
inabilities	inability
inaccuracies	inaccuracy
inadequacies	inadequacy
incapacities	incapacity
incas	inca
incendiaries	incendiary
inches	inch
incidences	incidence
incoherences	incoherence
incompetences	incompetence
incongruities	incongruity
inconsistencies	inconsistency
incontinences	incontinence
inconveniences	inconvenience
increases	increase
incumbencies	incumbency
indecencies	indecency
indefinables	indefinable
indemnities	indemnity
indescribables	indescribable
indeterminacies	indeterminacy
indexes	index
indices	index
indignities	indignity
indigoes	indigo
indios	indio
indispensables	indispensable
indivisibles	indivisible
indolences	indolence
inductances	inductance
indulgences	indulgence
industries	industry
inefficiencies	inefficiency
inequalities	inequality
inequities	inequity
inevitabilities	inevitability
inexpressibles	inexpressible
infamies	infamy
infantries	infantry
infantrymen	infantryman
inferences	inference
inferiorities	inferiority
infernos	inferno
infidelities	infidelity
infinities	infinity
infirmaries	infirmary
infirmities	infirmity
inflatables	inflatable
inflorescences	inflorescence
influences	influence
influxes	influx
informalities	informality
ingresses	ingress
inheritances	inheritance
inhumanities	inhumanity
iniquities	iniquity
injuries	injury
innuendoes	innuendo
inocula	inoculum
inquiries	inquiry
insanities	insanity
insecurities	insecurity
insensitivities	insensitivity
insignia	insignia
insignificances	insignificance
insincerities	insincerity
insolences	insolence
insolvencies	insolvency
inspectors-general	inspector-general
instabilities	instability
instances	instance
instrumentalities	instrumentality
insufficiencies	insufficiency
insurances	insurance
insurgencies	insurgency
intangibles	intangible
intelligences	intelligence
intelligentsias	intelligentsia
intelligibles	intelligible
intemperances	intemperance
intensities	intensity
interchanges	interchange
interdependences	interdependence
interdependencies	interdependency
interferences	interference
intermedia	intermedium
intermediaries	intermediary
interphases	interphase
interregna	interregnum
interrogatories	interrogatory
intimacies	intimacy
intimae	intima
intolerances	intolerance
intransigences	intransigence
intravenouses	intravenous
intricacies	intricacy
intrigues	intrigue
introductories	introductory
intros	intro
invariances	invariance
inventories	inventory
inverses	inverse
iotas	iota
iraqis	iraqi
irises	iris
irishmen	irishman
irishwomen	irishwoman
ironies	irony
iroquois	iroquois
irrationalities	irrationality
irregularities	irregularity
irrelevances	irrelevance
irresponsibles	irresponsible
irreverences	irreverence
isbns	isbn
isles	isle
isoenzymes	isoenzyme
isomerases	isomerase
isotypes	isotype
isozymes	isozyme
isps	isp
issuances	issuance
issues	issue
isthmuses	isthmus
itas	ita
itches	itch
itineraries	itinerary
itis	iti
ivies	ivy
ivis	ivi
ivories	ivory
jacobuses	jacobus
janizaries	janizary
januaries	january
japanese	japanese
jatakas	jataka
javanese	javanese
jealousies	jealousy
jejuna	jejunum
jellies	jelly
jellyfish	jellyfish
jemimas	jemima
jerries	jerry
jessies	jessie
jetties	jetty
jewesses	jewess
jewries	jewry
jinas	jina
jingles	jingle
jivas	jiva
jnanas	jnana
joes	joe
johnnies	johnny
jollies	jolly
journeymen	journeyman
joys	joy
jpegs	jpeg
judases	judas
judges	judge
judiciaries	judiciary
judies	judy
julys	july
jumbos	jumbo
jungles	jungle
junkies	junkie
juntas	junta
juries	jury
kabukis	kabuki
kafkas	kafka
kagos	kago
kamakuras	kamakura
kangaroos	kangaroo
kansas	kansa
kappas	kappa
karnatas	karnata
karyotypes	karyotype
kas	ka
kashmiris	kashmiri
katas	kata
kavas	kava
kellies	kelly
keratinocytes	keratinocyte
keratoses	keratosis
ketoacidoses	ketoacidosis
kettles	kettle
khasis	khasi
kibbutzim	kibbutz
kilobases	kilobase
kilogrammetres	kilogrammetre
kilometres	kilometre
kilos	kilo
kimonos	kimono
kinases	kinase
kinsmen	kinsman
kiowas	kiowa
kirbies	kirby
kisses	kiss
kivas	kiva
knowledges	knowledge
knuckles	knuckle
kolas	kola
konos	kono
krónas	króna
krauses	krause
kroner	krone
kshatriyas	kshatriya
kuwaitis	kuwaiti
labia	labium
laboratories	laboratory
lactamases	lactamase
lacunae	lacuna
ladies	lady
ladinos	ladino
ladles	ladle
laities	laity
lamas	lama
lambdas	lambda
lamellae	lamella
laminae	lamina
laminectomies	laminectomy
lances	lance
landes	lande
landladies	landlady
langues	langue
lans	lan
laparoscopies	laparoscopy
lapses	lapse
larcenies	larceny
larches	larch
larges	large
largesses	largess
largos	largo
larvae	larva
larynges	larynx
larynxes	larynx
lasses	lass
latas	lata
latches	latch
latencies	latency
latexes	latex
lathes	lathe
latinas	latina
latinos	latino
launches	launch
laundresses	laundress
laundries	laundry
laurences	laurence
lavas	lava
lavatories	lavatory
lawmen	lawman
laymen	layman
lazaruses	lazarus
lcds	lcd
leagues	league
leases	lease
leashes	leash
lebanese	lebanese
ledges	ledge
leds	led
leeches	leech
legacies	legacy
legendaries	legendary
legendres	legendre
lemmata	lemma
leniencies	leniency
lenses	lens
leucocytes	leucocyte
leukaemias	leukaemia
levies	levy
levities	levity
liabilities	liability
liases	lias
liberties	liberty
liberties	liberty
libidos	libido
libraries	library
libretti	libretto
librettos	libretto
lice	louse
licences	licence
lies	lie
lieutenants-general	lieutenant-general
lifestyles	lifestyle
ligases	ligase
lighthouses	lighthouse
lilies	lily
limbi	limbus
limbos	limbo
limos	limo
lindes	linde
lineas	linea
linemen	lineman
linguas	lingua
lipomata	lipoma
lire	lira
litanies	litany
literaries	literary
litres	litre
littles	little
liturgies	liturgy
liveries	livery
livres	livre
lizzies	lizzie
llamas	llama
llanos	llano
lobbies	lobby
lobectomies	lobectomy
localities	locality
loci	locus
locies	locie
lodges	lodge
loggias	loggia
logos	logo
lolitas	lolita
lomas	loma
longas	longa
longshoremen	longshoreman
loos	loo
lorenzes	lorenz
lorries	lorry
losses	loss
lotas	lota
lotteries	lottery
lotuses	lotus
lounges	lounge
louvres	louvre
lovelies	lovely
loyalties	loyalty
lozenges	lozenge
lucases	lucas
luckies	lucky
lullabies	lullaby
lumbermen	lumberman
luminaries	luminary
luminosities	luminosity
lunacies	lunacy
lunches	lunch
lunges	lunge
lurches	lurch
lustres	lustre
luxuries	luxury
lyases	lyase
lymphœdemas	lymphœdema
lymphocytes	lymphocyte
lymphomata	lymphoma
lymphosarcomas	lymphosarcoma
lynxes	lynx
lyres	lyre
mâches	mâche
mélanges	mélange
mêlées	mêlée
maîtres	maître
macaronies	macaroni
mackerel	mackerel
macquaries	macquarie
macrophytes	macrophyte
macros	macro
maculae	macula
madeiras	madeira
madhouses	madhouse
madmen	madman
madonnas	madonna
madrases	madras
madres	madre
maestri	maestro
mafias	mafia
magi	magus
maginnises	maginnis
magistracies	magistracy
magmata	magma
magnetos	magneto
magnolias	magnolia
magpies	magpie
maharajas	maharaja
maharishis	maharishi
mahas	maha
mahatmas	mahatma
mahdis	mahdi
mahoganies	mahogany
mailboxes	mailbox
mais	mai
majorities	majority
majors-general	major-general
make-dos	make-do
malaccas	malacca
maladies	malady
malagasy	malagasy
malaises	malaise
malas	mala
malignancies	malignancy
mallei	malleus
malleoli	malleolus
mallories	mallory
maltese	maltese
mamas	mama
mammaries	mammary
mammies	mammy
manchus	manchu
mandalas	mandala
mandatories	mandatory
mandibles	mandible
mangoes	mango
manias	mania
manifestos	manifesto
manilas	manila
manillas	manilla
manos	mano
mantles	mantle
mantras	mantra
manufactories	manufactory
manuses	manus
maoris	maori
mapais	mapai
maples	maple
maquiladoras	maquiladora
maras	mara
marathas	maratha
marbles	marble
marches	march
margeries	margery
marges	marge
mariannes	marianne
marias	maria
maries	mary
marinas	marina
marionettes	marionette
marksmen	marksman
marquises	marquis
marshes	marsh
marthas	martha
martinis	martini
marus	maru
maruyamas	maruyama
marvellouses	marvellous
masculinities	masculinity
massacres	massacre
masses	mass
mastectomies	mastectomy
matas	mata
matches	match
materialities	materiality
mathes	mathe
matières	matière
matriarchies	matriarchy
mattresses	mattress
maturities	maturity
mausolea	mausoleum
maxillae	maxilla
maxillaries	maxillary
maxima	maximum
maximuses	maximus
maybes	maybe
mayflies	mayfly
mayonnaises	mayonnaise
maythes	maythe
mazdas	mazda
mckenzies	mckenzie
mealies	mealie
meases	mease
meatus	meatus
media	medium
mediae	media
mediastina	mediastinum
medicos	medico
mediocres	mediocre
mediocrities	mediocrity
medios	medio
medullas	medulla
medulloblastomas	medulloblastoma
megabytes	megabyte
megakaryocytes	megakaryocyte
meijis	meiji
meinies	meinie
meioses	meiosis
melanocytes	melanocyte
melanomas	melanoma
melodies	melody
melodramas	melodrama
mementoes	memento
memorables	memorable
memoranda	memorandum
memories	memory
memos	memo
men	man
menageries	menagerie
menarches	menarche
meninges	meninx
meningiomata	meningioma
menisci	meniscus
menominee	menominee
menopauses	menopause
menses	mense
mentalities	mentality
menus	menu
meps	mep
meqs	meq
mercenaries	mercenary
merchantmen	merchantman
mercies	mercy
mercuries	mercury
mesas	mesa
mesenteries	mesentery
meshes	mesh
mesotheliomas	mesothelioma
messes	mess
mestizos	mestizo
metamorphoses	metamorphosis
metas	meta
metastases	metastasis
methodologies	methodology
methyldopas	methyldopa
methyltransferases	methyltransferase
metonymies	metonymy
metres	metre
metropolises	metropolis
metros	metro
mettles	mettle
mexes	mex
mexicanos	mexicano
mhzes	mhz
mice	mouse
micelles	micelle
microfiches	microfiche
microfilariae	microfilaria
micrometres	micrometre
micros	micro
microvilli	microvillus
middlemen	middleman
middles	middle
midges	midge
midrashim	midrash
midshipmen	midshipman
mighties	mighty
mihis	mihi
milieux	milieu
militancies	militancy
militiamen	militiaman
militias	militia
millennia	millennium
milles	mille
millilitres	millilitre
millimetres	millimetre
mimeos	mimeo
mimicries	mimicry
minas	mina
miniés	minié
minima	minimum
minis	mini
minis	mini
ministries	ministry
minorities	minority
mintos	minto
minuses	minus
miracles	miracle
miscellanies	miscellany
miserables	miserable
miseries	misery
mises	mis
miskito	miskito
mismatches	mismatch
misses	miss
missionaries	missionary
missouris	missouri
mistletoes	mistletoe
mistresses	mistress
misuses	misuse
mitochondria	mitochondrion
mitoses	mitosis
mitres	mitre
mitzvoth	mitzvah
mlas	mla
mlcs	mlc
mlles	mlle
mockeries	mockery
modalities	modality
modernes	moderne
modernities	modernity
modesties	modesty
moduli	modulus
moduses	modus
moieties	moiety
mois	moi
mollies	molly
momenta	momentum
momentos	momento
mommas	momma
mommies	mommy
monarchies	monarchy
monasteries	monastery
mondes	monde
monocytes	monocyte
monologues	monologue
monopolies	monopoly
monos	mono
monosyllables	monosyllable
monros	monro
monstrosities	monstrosity
montes	monte
monthlies	monthly
moonies	moonie
moralities	morality
morasses	morass
moratoria	moratorium
morbidities	morbidity
moritas	morita
moroccos	morocco
moros	moro
morphologies	morphology
morrises	morris
mortalities	mortality
mortuaries	mortuary
moses	mos
mosfets	mosfet
mosquitoes	mosquito
mosses	moss
motorcycles	motorcycle
mottoes	motto
motus	motu
mous	mou
moustaches	moustache
mouthwashes	mouthwash
movables	movable
movies	movie
mpas	mpa
mpegs	mpeg
muches	much
mucosae	mucosa
mudras	mudra
mulattoes	mulatto
mulberries	mulberry
mulches	mulch
multicollinearities	multicollinearity
multiples	multiple
multiplicities	multiplicity
multis	multi
mummies	mummy
municipalities	municipality
municipios	municipio
munros	munro
murphies	murphy
mus	mu
muscles	muscle
muscularises	muscularis
muses	muse
must-bes	must-be
mustaches	mustache
mutagenicities	mutagenicity
mutches	mutch
mutinies	mutiny
muzzles	muzzle
mycelia	mycelium
mycobacteria	mycobacterium
mycoplasmata	mycoplasma
mycoses	mycosis
myelographies	myelography
myelomata	myeloma
mynas	myna
myocytes	myocyte
myopathies	myopathy
myrtles	myrtle
mysteries	mystery
mythoi	mythos
mythologies	mythology
naïvetés	naïveté
naevi	naevus
nagas	naga
nais	nai
naiveties	naivety
nands	nand
nannies	nanny
nanometres	nanometre
nanoparticles	nanoparticle
nashes	nash
nasopharynges	nasopharynx
nationalities	nationality
nativities	nativity
naturelles	naturelle
navies	navy
navvies	navvy
nazis	nazi
ncos	nco
nebulae	nebula
nebulas	nebula
necessaries	necessary
necessities	necessity
neckties	necktie
necropolises	necropolis
needies	needy
needles	needle
negativities	negativity
negligences	negligence
negris	negri
negroes	negro
neisserias	neisseria
nemeses	nemesis
neophytes	neophyte
nephrectomies	nephrectomy
nephropathies	nephropathy
nerves	nerve
neses	nese
nesses	ness
nettles	nettle
neuroendocrinologies	neuroendocrinology
neurofibromata	neurofibroma
neuromata	neuroma
neurosciences	neuroscience
neuroses	neurosis
neutrinos	neutrino
newcastles	newcastle
newmen	newman
newsmen	newsman
newspapermen	newspaperman
nexus	nexus
niños	niño
niagaras	niagara
niceties	nicety
niches	niche
nickies	nicky
nighties	nightie
nigras	nigra
nineties	ninety
nipples	nipple
nirvanas	nirvana
nitrogenases	nitrogenase
nitros	nitro
nobilities	nobility
noblemen	nobleman
noblewomen	noblewoman
nobodies	nobody
noes	no
noises	noise
nominies	nominy
nonces	nonce
nonchalances	nonchalance
nonentities	nonentity
nonexistences	nonexistence
nonsenses	nonsense
nonyas	nonya
noodles	noodle
noois	nooi
nooses	noose
nors	nor
norsemen	norseman
noses	nose
nostalgias	nostalgia
notables	notable
notaries	notary
notas	nota
notches	notch
nouveaux	nouveau
nouvelles	nouvelle
novae	nova
novelas	novela
novellas	novella
novelties	novelty
nozzles	nozzle
nuances	nuance
nucleases	nuclease
nuclei	nucleus
nucleoli	nucleolus
nucleuses	nucleus
nuisances	nuisance
nullities	nullity
numas	numa
nuncios	nuncio
nunneries	nunnery
nurseries	nursery
nurses	nurse
nyayas	nyaya
nyssas	nyssa
oaps	oap
oarsmen	oarsman
oases	oasis
obeisances	obeisance
obeses	obese
obituaries	obituary
objectionables	objectionable
oboes	oboe
obscenities	obscenity
obscurities	obscurity
observables	observable
observances	observance
observatories	observatory
observes	observe
obsolescences	obsolescence
obstacles	obstacle
obstinacies	obstinacy
obverses	obverse
obviouses	obvious
occupancies	occupancy
occurrences	occurrence
oches	oche
octahedra	octahedron
octopi	octopus
octopodes	octopus
octopuses	octopus
oculi	oculus
oddities	oddity
oesophagi	oesophagus
oeuvres	oeuvre
offences	offence
ogres	ogre
oilmen	oilman
olfactories	olfactory
oligarchies	oligarchy
oligodendrocytes	oligodendrocyte
oligopolies	oligopoly
ombudsmen	ombudsman
omegas	omega
omelettes	omelette
omenta	omentum
omnibuses	omnibus
omnipotences	omnipotence
omnipresences	omnipresence
omnis	omni
omnisciences	omniscience
onces	once
oneida	oneida
onlies	only
onondaga	onondaga
ontologies	ontology
onuses	onus
oocytes	oocyte
operas	opera
operettas	operetta
opportunities	opportunity
optima	optimum
opulences	opulence
opuses	opus
oracles	oracle
oranges	orange
oras	ora
oratories	oratory
oratorios	oratorio
orbicularises	orbicularis
orchestras	orchestra
orderlies	orderly
ordinances	ordinance
ordinaries	ordinary
ordos	ordo
orebodies	orebody
organelles	organelle
orgies	orgy
orogenies	orogeny
oropharynxes	oropharynx
orthodoxes	orthodox
orthodoxies	orthodoxy
orthographies	orthography
orthoses	orthosis
osage	osage
ossicles	ossicle
osteomas	osteoma
osteophytes	osteophyte
osteosarcomata	osteosarcoma
osteotomies	osteotomy
ostia	ostium
ostriches	ostrich
othellos	othello
ottawas	ottawa
ounces	ounce
outcries	outcry
outhouses	outhouse
ova	ovum
ovaries	ovary
overdoses	overdose
overmen	overman
overseases	overseas
oxen	ox
oxidases	oxidase
oxygenases	oxygenase
pères	père
pacs	pac
padas	pada
paddies	paddy
paddles	paddle
padres	padre
pagodas	pagoda
paintbrushes	paintbrush
pakehas	pakeha
pakihis	pakihi
pakistanis	pakistani
palabras	palabra
palacios	palacio
palettes	palette
palladia	palladium
palsies	palsy
panaceas	panacea
panamas	panama
pancreases	pancreas
pandas	panda
panicles	panicle
panoplies	panoply
panoramas	panorama
pansies	pansy
pantries	pantry
papacies	papacy
papago	papago
papanicolaous	papanicolaou
papases	papas
papayas	papaya
papillae	papilla
papilloedemas	papilloedema
papillomata	papilloma
papillomaviruses	papillomavirus
papooses	papoose
papyri	papyrus
parables	parable
parabolae	parabola
paradises	paradise
paradoxes	paradox
paraesthesiae	paraesthesia
parallaxes	parallax
paralyses	paralysis
paramilitaries	paramilitary
paraphrases	paraphrase
parentheses	parenthesis
pareses	paresis
paretos	pareto
parganas	pargana
parishes	parish
parities	parity
parkas	parka
parles	parle
parliamentaries	parliamentary
parmas	parma
partialities	partiality
participles	participle
particles	particle
parties	partie
parties	party
partridges	partridge
passers-by	passer-by
passes	pass
pastas	pasta
pastiches	pastiche
pastilles	pastille
pastries	pastry
patches	patch
patellae	patella
pathogenesises	pathogenesis
pathologies	pathology
patinas	patina
patios	patio
patriarchies	patriarchy
patrias	patria
patrimonies	patrimony
patrolmen	patrolman
patties	patty
paucities	paucity
pauses	pause
pavias	pavia
pawnee	pawnee
peaches	peach
peas	pea
pebbles	pebble
pectoralises	pectoralis
peculiarities	peculiarity
pedagogies	pedagogy
pedagogues	pedagogue
pedantries	pedantry
peduncles	peduncle
peises	peise
pelves	pelvis
penalties	penalty
penances	penance
pence	penny
peninsulas	peninsula
penitences	penitence
penitentiaries	penitentiary
pennies	penny
penroses	penrose
pensées	pensée
penthouses	penthouse
pentoses	pentose
penumbrae	penumbra
peonies	peony
people	person
peps	pep
pepsis	pepsi
perch	perch
percies	percy
perfidies	perfidy
performances	performance
pericardia	pericardium
perinea	perineum
periostea	periosteum
peripheries	periphery
peris	peri
perishables	perishable
peritonea	peritoneum
perjuries	perjury
permanences	permanence
permanencies	permanency
permittivities	permittivity
perpetuities	perpetuity
perplexities	perplexity
perses	perse
personae	persona
personalities	personality
personalties	personalty
perversities	perversity
pesetas	peseta
pesos	peso
pestilences	pestilence
pestles	pestle
petechiae	petechia
petties	petty
pfellas	pfella
phaeochromocytomas	phaeochromocytoma
phagocytes	phagocyte
phalanges	phalange
phalanxes	phalanx
phalli	phallus
pharmacies	pharmacy
pharynges	pharynx
phases	phase
phases	phasis
phds	phd
phenomena	phenomenon
phenotypes	phenotype
phes	phe
philanthropies	philanthropy
phillies	philly
phillises	phillis
philosophes	philosophe
philosophies	philosophy
phis	phi
phobias	phobia
phoenixes	phoenix
photocopies	photocopy
photos	photo
phraseologies	phraseology
phrases	phrase
phus	phu
phyla	phylum
physes	physis
physiognomies	physiognomy
piani	piano
pianos	piano
piastres	piastre
piazzas	piazza
piccaninnies	piccaninny
pickles	pickle
pie	pie
piedras	piedra
pies	pie
pieties	piety
pilis	pili
pimples	pimple
pinches	pinch
pineapples	pineapple
pinnacles	pinnacle
pins	pin
pipettes	pipette
piracies	piracy
pis	pi
pistles	pistle
pitches	pitch
pittances	pittance
pituitaries	pituitary
pizzas	pizza
pki	pki
pks	pk
placebos	placebo
placentae	placenta
plagues	plague
plantés	planté
plateaux	plateau
plateaux	plateau
plausibles	plausible
playhouses	playhouse
plazas	plaza
plc	plc
pleas	plea
pleasantries	pleasantry
pledges	pledge
plenipotentiaries	plenipotentiary
plethoras	plethora
pleurae	pleura
plexus	plexus
ploughmen	ploughman
plunges	plunge
pluralities	plurality
pluses	plus
pneumococci	pneumococcus
pneumocystises	pneumocystis
podia	podium
poetesses	poetess
poetries	poetry
poignancies	poignancy
pointes	pointe
poises	poise
polarities	polarity
polarizabilities	polarizability
policemen	policeman
policies	policy
polioviruses	poliovirus
politicos	politico
polities	polity
polkas	polka
pollies	polly
pollies	polly
polyelectrolytes	polyelectrolyte
polyhedra	polyhedron
polymerases	polymerase
polyphonies	polyphony
polys	poly
ponchos	poncho
ponies	pony
poodles	poodle
poonas	poona
poorhouses	poorhouse
poppies	poppy
porches	porch
poros	poro
porphyries	porphyry
porpoises	porpoise
portas	porta
portes	porte
portfolios	portfolio
portias	portia
porticoes	portico
portuguese	portuguese
pos	po
positivities	positivity
poss	pos
possibilities	possibility
possibles	possible
possiblies	possibly
postmen	postman
postmodernities	postmodernity
potatoes	potato
potawatomi	potawatomi
potencies	potency
potentialities	potentiality
potteries	pottery
pouches	pouch
powerhouses	powerhouse
pows	pow
poxes	pox
prahus	prahu
prairies	prairie
praises	praise
prakritis	prakriti
preferences	preference
prefixes	prefix
pregnancies	pregnancy
preliminaries	preliminary
premises	premise
preparatories	preparatory
preponderances	preponderance
presbyteries	presbytery
presciences	prescience
presences	presence
preserves	preserve
presidencies	presidency
presidios	presidio
presses	press
pretences	pretence
pretenses	pretense
pretties	pretty
prevalences	prevalence
priestesses	priestess
primaries	primary
primeros	primero
primordia	primordium
primos	primo
primroses	primrose
princes	prince
princesses	princess
principalities	principality
principles	principle
priories	priory
priorities	priority
privies	privy
privities	privity
probabilities	probability
probables	probable
probosces	proboscis
processes	process
processuses	processus
proclivities	proclivity
prodigies	prodigy
profanities	profanity
proficiencies	proficiency
profundities	profundity
progenies	progeny
prognoses	prognosis
programmes	programme
progresses	progress
prolegomena	prolegomenon
prologues	prologue
prominences	prominence
promises	promise
promontories	promontory
propensities	propensity
properties	property
prophecies	prophecy
prophetesses	prophetess
proprietaries	proprietary
proprieties	propriety
pros	pro
proscenia	proscenium
proses	prose
prosodies	prosody
prospectuses	prospectus
prosperos	prospero
prosses	pross
prostatectomies	prostatectomy
prostheses	prosthesis
protégés	protégé
proteases	protease
proteinases	proteinase
proteuses	proteus
prototypes	prototype
protozoa	protozoon
protuberances	protuberance
provenances	provenance
provinces	province
proxies	proxy
prudences	prudence
pseudos	pseudo
psias	psia
psoases	psoas
psyches	psyche
psychodramas	psychodrama
psychologies	psychology
psychos	psycho
psychoses	psychosis
ptas	pta
puddles	puddle
pueblos	pueblo
puissances	puissance
pujas	puja
pulaskis	pulaski
pulmonaries	pulmonary
pulses	pulse
punjabis	punjabi
pupae	pupa
puppies	puppy
puranas	purana
purchases	purchase
purgatories	purgatory
purples	purple
purposes	purpose
purses	purse
purushas	purusha
pusses	puss
pussies	pussy
putamina	putamen
putsches	putsch
putties	putty
puzzles	puzzle
pygmies	pygmy
pylori	pylorus
pyres	pyre
québécoises	québécois
quadrangles	quadrangle
qualities	quality
quandaries	quandary
quanta	quantum
quantifiables	quantifiable
quantities	quantity
quarries	quarry
quarterlies	quarterly
quartos	quarto
quaternaries	quaternary
quatres	quatre
quelles	quelle
queues	queue
quintessences	quintessence
quittances	quittance
quos	quo
quotas	quota
quoys	quoy
rabbis	rabbi
racehorses	racehorse
radii	radius
radios	radio
radishes	radish
raes	rae
ragas	raga
railwaymen	railwayman
rais	rai
rajas	raja
rami	ramus
ramies	ramie
ranas	rana
ranchos	rancho
ranges	range
ranis	rani
raos	rao
rap	rap
rarities	rarity
rasas	rasa
rases	ras
rases	ras
raspberries	raspberry
ratas	rata
ratios	ratio
rattles	rattle
razas	raza
reactances	reactance
reactionaries	reactionary
realities	reality
reanalysises	reanalysis
reappearances	reappearance
reas	rea
reassurances	reassurance
rebeccas	rebecca
rebuses	rebus
receivables	receivable
receptacles	receptacle
recesses	recess
recluses	recluse
reconnaissances	reconnaissance
recourses	recourse
recoveries	recovery
recta	rectum
rectangles	rectangle
recti	rectus
rectories	rectory
recurrences	recurrence
rediscoveries	rediscovery
redresses	redress
reductases	reductase
redundancies	redundancy
refectories	refectory
references	reference
referenda	referendum
refineries	refinery
reflectances	reflectance
reflexes	reflex
reformatories	reformatory
refractories	refractory
regencies	regency
reginas	regina
registries	registry
regresses	regress
regularities	regularity
reindeer	reindeer
reinforces	reinforce
reinsurances	reinsurance
releases	release
relevances	relevance
relevancies	relevancy
reliables	reliable
reliances	reliance
religieuses	religieuse
religious	religious
rem	rem
rem	rem
remarkables	remarkable
remedies	remedy
remembrances	remembrance
reminiscences	reminiscence
remittances	remittance
remonstrances	remonstrance
rendezvous	rendezvous
renewables	renewable
repairmen	repairman
repentances	repentance
repertories	repertory
replicas	replica
replies	reply
repositories	repository
reprises	reprise
reproaches	reproach
rescues	rescue
researches	research
resemblances	resemblance
reserves	reserve
residences	residence
residencies	residency
residua	residuum
residues	residue
resiliences	resilience
resiliencies	resiliency
resistances	resistance
resolves	resolve
resonances	resonance
resources	resource
responsa	responsum
responses	response
responsibilities	responsibility
responsibles	responsible
responsivities	responsivity
resurgences	resurgence
retia	rete
reticences	reticence
reticula	reticulum
reticulocytes	reticulocyte
retinae	retina
retinues	retinue
retroviruses	retrovirus
revelries	revelry
revenues	revenue
reverences	reverence
reveries	reverie
reverses	reverse
revises	revise
revolutionaries	revolutionary
revues	revue
rhabdomyosarcomata	rhabdomyosarcoma
rhes	rhe
rhesuses	rhesus
rhinoceroses	rhinoceros
rhos	rho
rhymes	rhyme
rias	ria
richelieus	richelieu
riches	rich
riddles	riddle
ridges	ridge
ridiculouses	ridiculous
riflemen	rifleman
rifles	rifle
righteouses	righteous
rigvedas	rigveda
rinpoches	rinpoche
rinses	rinse
rios	rio
rises	rise
rishis	rishi
ritzes	ritz
rivalries	rivalry
rivas	riva
rivieras	riviera
robberies	robbery
robles	roble
rodeos	rodeo
rogues	rogue
rolves	rolf
roma	rom
romances	romance
romeos	romeo
rookies	rookie
rories	rory
rorschaches	rorschach
rosaries	rosary
roses	rose
rosettes	rosette
roshas	rosha
rosies	rosie
rostra	rostrum
rotaries	rotary
rotaviruses	rotavirus
rotundas	rotunda
roubles	rouble
roulettes	roulette
rouses	rouse
royalties	royalty
roys	roy
rubies	ruby
ruggles	ruggle
ruses	ruse
rushes	rush
russes	russ
rvs	rv
ryes	rye
séances	séance
sabras	sabra
sacra	sacrum
saddles	saddle
sadhus	sadhu
safaris	safari
safeties	safety
sagas	saga
sagos	sago
saharas	sahara
sakés	saké
sakas	saka
saktis	sakti
salaries	salary
salas	sala
salesmen	salesman
saliences	salience
salinities	salinity
salish	salish
sallies	sally
salmonellas	salmonella
salsas	salsa
salvoes	salvo
samadhis	samadhi
samajs	samaj
samhitas	samhita
sammies	sammy
samples	sample
sams	sam
sanatoria	sanatorium
sanchos	sancho
sanctities	sanctity
sanctuaries	sanctuary
sandinistas	sandinista
sandwiches	sandwich
sanghas	sangha
sanitaria	sanitarium
sankhyas	sankhya
sarcomata	sarcoma
sarcophagi	sarcophagus
saris	sari
sashes	sash
sats	sat
saunas	sauna
sautés	sauté
savageries	savagery
savoys	savoy
saxes	saxe
sayas	saya
scapulae	scapula
scarcities	scarcity
scenarios	scenario
schatzes	schatz
schemata	schema
schoolboys	schoolboy
schoolchildren	schoolchild
schoolhouses	schoolhouse
schoolmen	schoolman
schottkies	schottky
schwarzes	schwarz
sciences	science
sclerae	sclera
scleroses	sclerosis
scotches	scotch
scotomata	scotoma
scotsmen	scotsman
scotties	scotty
scottishes	scottish
scourges	scourge
screeches	screech
scrota	scrotum
scruples	scruple
scrutinies	scrutiny
scubas	scuba
scythes	scythe
seals	seal
seamen	seaman
seamstresses	seamstress
searches	search
seas	sea
sec	sec
secondaries	secondary
secretaries	secretary
secretaries-general	secretary-general
secretories	secretory
securities	security
sedges	sedge
sedimentaries	sedimentary
sehnas	sehna
seitzes	seitz
selectmen	selectman
sellae	sella
selves	self
semblances	semblance
semicircles	semicircle
seminaries	seminary
semples	semple
sems	sem
senses	sense
sensories	sensory
sentences	sentence
sententias	sententia
sentimentalities	sentimentality
sentries	sentry
sephardim	sephardi
sepoys	sepoy
septa	septum
sepulchres	sepulchre
sequelae	sequela
sequences	sequence
sequoias	sequoia
sera	serum
seraphim	seraph
series	series
serotypes	serotype
serranos	serrano
sertolis	sertoli
servicemen	serviceman
servos	servo
ses	se
sesses	sess
setae	seta
settles	settle
seventies	seventy
severances	severance
severities	severity
sexes	sex
sexualities	sexuality
shabbosim	shabbos
shackles	shackle
shanties	shanty
sharias	sharia
shas	sha
shastas	shasta
shastras	shastra
shellfish	shellfish
shelves	shelf
shermen	sherman
sherpa	sherpa
sherries	sherry
shigellas	shigella
shoes	shoe
shous	shou
showcases	showcase
showmen	showman
shrubberies	shrubbery
shtetlach	shtetl
shuttles	shuttle
sienas	siena
sierras	sierra
siestas	siesta
sifrei	sefer
sigmas	sigma
signatories	signatory
silences	silence
silhouettes	silhouette
silicas	silica
silos	silo
silvas	silva
similarities	similarity
simples	simple
simplexes	simplex
simplicities	simplicity
simulacra	simulacrum
sindhis	sindhi
singles	single
singularities	singularity
sinuses	sinus
sissies	sissy
situses	situs
sivas	siva
sixes	six
sixpences	sixpence
sixties	sixty
sketches	sketch
skies	sky
skirmishes	skirmish
skis	ski
slaughterhouses	slaughterhouse
sledges	sledge
slrs	slr
sludges	sludge
slurries	slurry
smallpoxes	smallpox
smithies	smithy
snatches	snatch
snobberies	snobbery
socialties	socialty
societies	society
sodas	soda
soes	soe
sofas	sofa
sohos	soho
soldieries	soldiery
solemnities	solemnity
soleuses	soleus
solicitors-general	solicitor-general
solidi	solidus
soliloquies	soliloquy
solitaries	solitary
solos	solo
solvencies	solvency
somas	soma
somebodies	somebody
sonatas	sonata
sonnes	sonne
sophias	sophia
sophies	sophy
sophistries	sophistry
sopranos	soprano
sorceresses	sorceress
sororities	sorority
sorries	sorry
sorties	sortie
sotos	soto
sources	source
sous	sou
sovereignties	sovereignty
soyas	soya
sparkles	sparkle
spas	spa
spatulas	spatula
spearmen	spearman
specialities	speciality
specialties	specialty
species	species
speckles	speckle
spectacles	spectacle
spectra	spectrum
spectres	spectre
specula	speculum
speeches	speech
sperm	sperm
spermatocytes	spermatocyte
spermatozoa	spermatozoon
spies	spy
spinaches	spinach
spinas	spina
spindles	spindle
spiritualities	spirituality
spitzes	spitz
splenectomies	splenectomy
spokesmen	spokesman
spokespeople	spokesperson
spondylolistheses	spondylolisthesis
sponges	sponge
sporangia	sporangium
sportsmen	sportsman
spouses	spouse
srimatis	srimati
ssris	ssri
stables	stable
stadia	stadium
stagecoaches	stagecoach
staircases	staircase
stand-bys	stand-by
stanzas	stanza
staphylococci	staphylococcus
staples	staple
starfish	starfish
stases	stasis
statesmen	statesman
stationarities	stationarity
statuaries	statuary
statues	statue
statuettes	statuette
statuses	status
stds	std
steadies	steady
steatorrhœas	steatorrhœa
stedmen	stedman
steeples	steeple
stelae	stela
stenches	stench
stenoses	stenosis
stepchildren	stepchild
stepfamilies	stepfamily
steppes	steppe
stereos	stereo
stereotypes	stereotype
sterna	sternum
stewardesses	stewardess
stigmata	stigma
stimuli	stimulus
stitches	stitch
stockmen	stockman
stoicheiometries	stoicheiometry
stomata	stoma
stopwatches	stopwatch
storehouses	storehouse
stories	story
strata	stratum
strategies	strategy
strawberries	strawberry
streptococci	streptococcus
stresses	stress
stretches	stretch
striae	stria
striata	striatum
stringencies	stringency
stromata	stroma
strophes	strophe
struggles	struggle
studies	study
studios	studio
stupas	stupa
stupidities	stupidity
styles	style
styli	stylus
subcategories	subcategory
subclasses	subclass
subdirectories	subdirectory
subfamilies	subfamily
subjectivities	subjectivity
sublimities	sublimity
submenus	submenu
submergences	submergence
submersibles	submersible
submucosae	submucosa
subpœnas	subpœna
subsamples	subsample
subserviences	subservience
subsidiaries	subsidiary
subsidies	subsidy
subsistences	subsistence
subspecies	subspecies
substances	substance
substrata	substratum
subtitles	subtitle
subtleties	subtlety
subtypes	subtype
successes	success
sudanese	sudanese
sudras	sudra
sufficiencies	sufficiency
suffixes	suffix
suitcases	suitcase
sulci	sulcus
sullas	sulla
sulphonylureas	sulphonylurea
sulus	sulu
summae	summa
summaries	summary
summonses	summons
sunni	sunni
sunrises	sunrise
superclasses	superclass
superegos	superego
superfluities	superfluity
superheroes	superhero
superintendences	superintendence
supermen	superman
supernovae	supernova
supplies	supply
suppositories	suppository
suprêmes	suprême
sureties	surety
surgeries	surgery
surges	surge
surmises	surmise
surpluses	surplus
surprises	surprise
susceptibilities	susceptibility
sutras	sutra
suvs	suv
suzerainties	suzerainty
swadeshis	swadeshi
swastikas	swastika
swatches	swatch
sweeties	sweetie
switches	switch
syces	syce
syllabi	syllabus
syllables	syllable
symbioses	symbiosis
symmetries	symmetry
sympathectomies	sympathectomy
sympathies	sympathy
symphonies	symphony
symphyses	symphysis
symposia	symposium
synagogues	synagogue
synapses	synapse
synergies	synergy
synonymies	synonymy
synopses	synopsis
syntaxes	syntax
synthases	synthase
syntheses	synthesis
synthetases	synthetase
syringes	syringe
têtes	tête
tabernacles	tabernacle
tableaux	tableau
taboos	taboo
tabulas	tabula
tackles	tackle
tacos	taco
taeniae	taenia
tais	tai
tali	talus
talkies	talkie
tallies	tally
tangibles	tangible
tanneries	tannery
tantras	tantra
taos	tao
tapestries	tapestry
taros	taro
tarsi	tarsus
tastes	taste
tattoos	tattoo
taus	tau
tautologies	tautology
taxa	taxon
taxables	taxable
taxes	tax
taxis	taxi
taxonomies	taxonomy
teagues	teague
teas	tea
technicalities	technicality
technologies	technology
tecta	tectum
teddies	teddy
teeth	tooth
telangiectases	telangiectasis
teleologies	teleology
telexes	telex
teloi	telos
telugu	telugu
tempi	tempo
temples	temple
temporalises	temporalis
temporalities	temporality
temporaries	temporary
tenancies	tenancy
tendencies	tendency
tenses	tense
tentacles	tentacle
teratomata	teratoma
termini	terminus
terminologies	terminology
terra-cottas	terra-cotta
terribles	terrible
territories	territory
tertiaries	tertiary
teslas	tesla
testae	testa
testimonies	testimony
tetrahedra	tetrahedron
tetralogies	tetralogy
thalami	thalamus
thalli	thallus
thanas	thana
theatres	theatre
thecae	theca
theocracies	theocracy
theodicies	theodicy
theologies	theology
theories	theory
therapies	therapy
thermocouples	thermocouple
thesauri	thesaurus
theses	thesis
thetas	theta
thimbles	thimble
thirties	thirty
thistles	thistle
thomases	thomas
thoracotomies	thoracotomy
throes	throe
thrombi	thrombus
thromboses	thrombosis
throttles	throttle
thrushes	thrush
thymes	thyme
thymi	thymus
thymocytes	thymocyte
thymomata	thymoma
thyroidectomies	thyroidectomy
tiaras	tiara
tibiae	tibia
ties	tie
timetables	timetable
tinies	tiny
tiptoes	tiptoe
tiros	tiro
tissues	tissue
tithes	tithe
titles	title
titres	titre
tobaccos	tobacco
toes	toe
togas	toga
toggles	toggle
tois	toi
tolerances	tolerance
tomatoes	tomato
tommies	tommy
tonalities	tonality
tongues	tongue
tonnes	tonne
tonys	tony
toolboxes	toolbox
toothaches	toothache
toothbrushes	toothbrush
topographies	topography
topoi	topos
topologies	topology
torches	torch
tori	torus
tories	tory
tornadoes	tornado
torpedoes	torpedo
torsi	torso
torsos	torso
tortillas	tortilla
tortoises	tortoise
tos	to
totalities	totality
touches	touch
tourettes	tourette
townsmen	townsman
toys	toy
trabeculae	trabecula
traceries	tracery
tracheae	trachea
tracheostomies	tracheostomy
tracheotomies	tracheotomy
tradesmen	tradesman
tragedies	tragedy
tragi	tragus
trajectories	trajectory
trances	trance
tranches	tranche
transaminases	transaminase
transcendences	transcendence
transferases	transferase
transiences	transience
transmittances	transmittance
transparencies	transparency
transverses	transverse
trapezii	trapezius
traumata	trauma
travelogues	travelogue
traverses	traverse
travesties	travesty
treacheries	treachery
treasuries	treasury
treaties	treaty
treatises	treatise
trebles	treble
trellises	trellis
trembles	tremble
trenches	trench
trespasses	trespass
tresses	tress
trestles	trestle
triangles	triangle
tribesmen	tribesman
tributaries	tributary
trickeries	trickery
tricycles	tricycle
tries	try
trifles	trifle
trilogies	trilogy
trinities	trinity
trios	trio
triples	triple
tris	tri
trisomies	trisomy
trivialities	triviality
trna	trna
trophies	trophy
troubles	trouble
truancies	truancy
trues	true
truffles	truffle
trusses	truss
trypanosomas	trypanosoma
tsetses	tsetse
tsunamis	tsunami
tsus	tsu
tubercles	tubercle
tummies	tummy
tumuli	tumulus
tundras	tundra
tunicae	tunica
tuples	tuple
turbos	turbo
turntables	turntable
turquoises	turquoise
turtles	turtle
tuttis	tutti
tuxedoes	tuxedo
tvs	tv
twelves	twelve
twenties	twenty
twinges	twinge
twos	two
tympana	tympanum
types	type
typologies	typology
tyrannies	tyranny
ufos	ufo
ulemas	ulema
ulnae	ulna
ulnas	ulna
ultimas	ultima
ultimata	ultimatum
ultras	ultra
umbilici	umbilicus
umbrellas	umbrella
umno	umno
unas	una
unattainables	unattainable
uncertainties	uncertainty
uncles	uncle
uncomfortables	uncomfortable
unconformities	unconformity
underclasses	underclass
undersecretaries	undersecretary
understudies	understudy
undesirables	undesirable
unholies	unholy
unido	unido
uniformities	uniformity
unintelligibles	unintelligible
unis	uni
unities	unity
universes	universe
universities	university
unknowables	unknowable
unlesses	unless
unnecessaries	unnecessary
unos	uno
unquestionables	unquestionable
unspeakables	unspeakable
untouchables	untouchable
upsurges	upsurge
urbinos	urbino
urethrae	urethra
urgencies	urgency
urinalyses	urinalysis
urls	url
uruses	urus
usbs	usb
uses	use
uteri	uterus
utopias	utopia
utterances	utterance
vacancies	vacancy
vacua	vacuum
vagaries	vagary
vagi	vagus
vaginas	vagina
vagrancies	vagrancy
vais	vai
valances	valance
valencies	valency
validities	validity
valises	valise
valsalvas	valsalva
valuables	valuable
values	value
valves	valve
vanillas	vanilla
vanities	vanity
varas	vara
variabilities	variability
variables	variable
variances	variance
varies	vary
varieties	variety
varnas	varna
varnishes	varnish
vars	var
varsities	varsity
vasa	vas
vasectomies	vasectomy
vases	vase
vaudevilles	vaudeville
vcrs	vcr
vedas	veda
vegetables	vegetable
vehemences	vehemence
vehicles	vehicle
velocities	velocity
venas	vena
vendettas	vendetta
ventricles	ventricle
venturis	venturi
venues	venue
verandas	veranda
verges	verge
veries	very
verities	verity
vermes	vermis
vernés	verné
veronicas	veronica
verses	verse
versos	verso
vertebrae	vertebra
vesicles	vesicle
vestries	vestry
vetoes	veto
vias	via
viceroys	viceroy
vicinities	vicinity
victories	victory
videocassettes	videocassette
videos	video
viennese	viennese
vies	vie
vigilantes	vigilante
vignettes	vignette
vikramas	vikrama
vilas	vila
villainies	villainy
villas	villa
villi	villus
virginias	virginia
virtues	virtue
virtuosi	virtuoso
virulences	virulence
viruses	virus
visas	visa
viscosities	viscosity
visionaries	visionary
vistas	vista
vitas	vita
vitrectomies	vitrectomy
vocabularies	vocabulary
vodkas	vodka
vogues	vogue
volcanoes	volcano
volterras	volterra
voltes	volte
voluntaries	voluntary
volvuli	volvulus
voodoos	voodoo
vortexes	vortex
vortices	vortex
votaries	votary
vulgarities	vulgarity
vulnerabilities	vulnerability
vulvas	vulva
wadis	wadi
wahabis	wahabi
wais	wai
waitresses	waitress
walaches	walach
walruses	walrus
waltzes	waltz
wans	wan
warehouses	warehouse
warranties	warranty
washes	wash
washoes	washoe
wasp	wasp
wastes	waste
watches	watch
watchmen	watchman
watercourses	watercourse
waxes	wax
weaponries	weaponry
wedges	wedge
weeklies	weekly
welshmen	welshman
weltanschauungen	weltanschauung
wenches	wench
werewolves	werewolf
wernickes	wernicke
wharves	wharf
whaus	whau
whiskies	whisky
whistles	whistle
wilis	wili
winches	winch
wineries	winery
winnebago	winnebago
wirelesses	wireless
wishes	wish
witcheries	witchery
witches	witch
withes	withe
wobblies	wobbly
woes	woe
wolves	wolf
women	woman
woodburies	woodbury
woolwiches	woolwich
workbenches	workbench
workforces	workforce
workhouses	workhouse
workmen	workman
works-in-progress	work-in-progress
worries	worry
worthies	worthy
wretches	wretch
wrinkles	wrinkle
wristwatches	wristwatch
xenopuses	xenopus
xeroxes	xerox
yahoos	yahoo
yamatos	yamato
yaqui	yaqui
yemenis	yemeni
yeomen	yeoman
yeshivas	yeshiva
yogis	yogi
yourselves	yourself
yous	you
yuccas	yucca
zapatistas	zapatista
zebras	zebra
zeemen	zeeman
zemstvos	zemstvo
zeroes	zero
zeros	zero
zinnias	zinnia
zlotys	zloty
zombies	zombie
zonas	zona
zoos	zoo
zuñis	zuñi
zulus	zulu
